{
    "Level_1" : {
        "Row" : 28,
        "Col" : 28,
        "Base" : { "X" : 14,  "Y" : 2},
        "Difficul" : 1,
        "EnemyCount" : 20,
        "EnemyStart" : [
            { "X" : 2,  "Y" : 26},
            { "X" : 14, "Y" : 26},
            { "X" : 26, "Y" : 26}
        ],
        "UserStart" : [
            { "X" : 11, "Y" : 2},
            { "X" : 17, "Y" : 2}
        ],
        "Data" : [
            "############################",
            "#00000000000000000000000000#",
            "#00000000000000000000000000#",
            "#00110011001100110011001100#",
            "#00110011001100110011001100#",
            "#00110011001100110011001100#",
            "#00110011001100110011001100#",
            "#00110011001122110011001100#",
            "#00110011001122110011001100#",
            "#00110011001100110011001100#",
            "#00110011000000000011001100#",
            "#00110011000000000011001100#",
            "#00000000001100110000000000#",
            "#00000000001100110000000000#",
            "#11001111000000000011110011#",
            "#22001111000000000011110022#",
            "#00000000001100110000000000#",
            "#00000000001111110000000000#",
            "#00110011001111110011001100#",
            "#00110011001100110011001100#",
            "#00110011001100110011001100#",
            "#00110011001100110011001100#",
            "#00110011000000000011001100#",
            "#00110011000000000011001100#",
            "#00110011000111100011001100#",
            "#00000000000100100000000000#",
            "#00000000000100100000000000#",
            "############################"
        ]
    }
}